[
  {
    "title": "Cave",
    "tileset": "tilemap_cave",
    "rockId": 1214,
    "data":[
        [0, 0, 0, 0, 0, 0, 0, 0, 0, 0, 0, 0, 0, 0, 0],
        [0, 1214, 0, 1214, 0, 1214, 0, 1214, 0, 1214, 0, 1214, 0, 1214, 0],
        [0, 0, 0, 0, 0, 0, 0, 0, 0, 0, 0, 0, 0, 0, 0],
        [0, 1214, 0, 1214, 0, 1214, 0, 1214, 0, 1214, 0, 1214, 0, 1214, 0],
        [0, 0, 0, 0, 0, 0, 0, 0, 0, 0, 0, 0, 0, 0, 0],
        [0, 1214, 0, 1214, 0, 1214, 0, 1214, 0, 1214, 0, 1214, 0, 1214, 0],
        [0, 0, 0, 0, 0, 0, 0, 0, 0, 0, 0, 0, 0, 0, 0],
        [0, 1214, 0, 1214, 0, 1214, 0, 1214, 0, 1214, 0, 1214, 0, 1214, 0],
        [0, 0, 0, 0, 0, 0, 0, 0, 0, 0, 0, 0, 0, 0, 0]
      ]

  },
  {
    "title": "Ice Cave",
    "tileset": "tilemap_cave",
    "rockId": 974,
    "data":[
      [0, 0, 0, 0, 0, 0, 0, 0, 0, 0, 0, 0, 0, 0, 0],
      [0, 974, 974, 974, 974, 974, 974, 0, 974, 0, 0, 0, 0, 0, 0],
      [0, 0, 0, 0, 0, 0, 974, 974, 974, 0, 974, 974, 974, 974, 0],
      [0, 0, 974, 974, 974, 0, 974, 0, 974, 0, 0, 0, 0, 974, 0],
      [0, 0, 0, 0, 974, 0, 974, 0, 974, 0, 0, 0, 0, 0, 0],
      [0, 974, 974, 0, 974, 0, 0, 0, 0, 0, 974, 0, 0, 974, 0],
      [0, 0, 0, 0, 974, 0, 974, 974, 974, 974, 974, 974, 0, 0, 0],
      [0, 0, 974, 974, 974, 0, 974, 0, 0, 974, 0, 0, 0, 974, 0],
      [0, 0, 0, 0, 0, 0, 0, 0, 0, 974, 0, 0, 0, 974, 0]
    ]
  },
  {
    "title": "Grass",
    "tileset": "tilemap_grass",
    "rockId": 23,
    "data":[
        [0, 0, 0, 0, 0, 0, 0, 0, 0, 0, 0, 0, 0, 0, 0],
        [0, 0, 23, 0, 23, 0, 23, 0, 23, 0, 23, 0, 23, 0, 0],
        [0, 0, 0, 0, 23, 0, 23, 0, 0, 0, 0, 0, 0, 0, 0],
        [0, 23, 23, 0, 23, 0, 0, 0, 23, 0, 0, 23, 23, 23, 0],
        [0, 0, 0, 0, 23, 0, 23, 0, 0, 0, 0, 0, 0, 23, 0],
        [0, 23, 23, 0, 23, 0, 23, 23, 23, 23, 23, 23, 0, 23, 0],
        [0, 0, 23, 0, 0, 0, 0, 23, 0, 23, 0, 23, 0, 23, 0],
        [0, 0, 23, 0, 23, 23, 23, 23, 0, 0, 0, 23, 0, 0, 0],
        [0, 0, 0, 0, 0, 0, 0, 0, 0, 0, 0, 0, 0, 0, 0]
      ]
  }
]
